Esc: mode Normal
i: insert(con trỏ nằm trước chữ) (mode Insert)
a: after( con trỏ nằm sau chữ) (mode Insert)
I: Đầu dòng và chuyển sang insert
A: End line (cuối dòng) và chuyển sang insert
0: nhảy lên đầu dòng
$: nhảy xuống cuối dòng
o: new line(dòng tiếp theo)
O: nhảy lên dòng trước
u: undo
ctrl r: redo
V: bôi đen cả dòng
viw: bôi đen 1 từ
gg: di chuyển lên đầu file
G: di chuyển xuống cuối file
w: nhảy lên từ tiếp theo
b: nhảy lùi về từ trước đó
-: nhảy lên đầu dòng trước đó
y: copy đoạn được bôi đen
p: paste đoạn bôi đen phía sau con trỏ
P: paste đoạn bôi đen phía trước con trỏ
J: xóa dòng bên dưới(những chữ trên dòng đó sẽ được chuyển lên dòng trên)
d: cut đoạn bôi đen
dd: xóa 1 hàng
dw: xóa 1 từ
/[Từ cần tìm]: tìm từ
n: next: từ cần tìm tiếp theo
N: từ cần tìm trước đó
:%s/text_cũ/text_mới: thay thế toàn bộ text cũ thành text mới
:noh : xóa các tìm kiếm



Esc v: mode Visual
di chuyển con trỏ chuột sẽ bôi đen từ
ggVG: bôi đen toàn bộ văn bản

: mode Command
echo: xuất
let [ten bien] = [gia tri]: khai báo và gán giá trị cho biến
echo [ten bien]: xuất giá trị biến
echo "ghi chú": xuất dòng ghi chú
[số]: di chuyển lên dòng [số]

